+-+-+-+-+-+-+-+-+-+-+-+-+-+-+-+-+-+-+-+-+
|       |       |   |           |       |
+ + +-+-+ + +-+ + + + +-+-+-+ + + + +-+-+
| | |     |   | | | | | |     | | |     |
+-+ + +-+-+-+ + + +-+ + + +-+-+ + +-+-+ +
|   | |     | | |   | | |   |   |   |   |
+ + + + +-+ + + +-+ + + +-+ +-+ +-+-+ +-+
| | | |   | | |     | |   |   |     |   |
+ + + +-+-+ + +-+-+ + + + +-+ +-+-+ +-+ +
| | |       |     | |   | |   | |   |   |
+ +-+-+-+-+ +-+-+ +-+ +-+-+ +-+ + +-+ +-+
| |       | |     |   |     |   | | |   |
+ + +-+-+ + + +-+-+ +-+ +-+-+ + + + + + +
| |     |   |   |   | | |   | |   |   | |
+ +-+-+ +-+-+-+ + +-+ + +-+ + +-+-+-+-+ +
| |   |     | |       |   |   |     |   |
+ + + +-+-+ + +-+-+-+-+-+ + +-+ +-+ + +-+
|   |     |     |         |   | | | |   |
+ +-+ +-+-+-+ +-+ +-+-+-+-+-+ + + + + + +
|   | |       |   |   |     |   | | | | |
+-+-+ + +-+-+-+ +-+ + + +-+ +-+-+ + +-+ +
|     |   |     |   | | | |       |     |
+ +-+-+-+ + +-+-+ + +-+ + +-+-+-+ +-+-+ +
|         |   |   | |   |   |   |   |   |
+-+-+-+-+-+-+ + + +-+ +-+ + + + +-+ + +-+
|             | | |   |   |   |   | | | |
+ +-+-+-+-+-+-+-+ + +-+ +-+-+-+-+ + + + +
|             |   | |           | |   | |
+ +-+-+-+-+-+ + +-+ +-+-+ +-+-+-+ +-+-+ +
| |         | |   | |   | |     |       |
+-+ +-+-+-+ + + + + + + + + +-+ + + +-+ +
|   |   |     | | |   | | | |   | | | | |
+ +-+ + +-+-+-+-+ +-+-+ +-+ + +-+-+ + + +
|     |   |           |     |       |   |
+ +-+-+-+ + +-+ +-+-+-+-+-+-+-+-+-+-+ +-+
| |     | | | |     |   |         |   | |
+ + + +-+ +-+ + +-+ + + + +-+ +-+-+ +-+ +
| | |   |   | | | |   |   |   |     |   |
+ +-+-+ +-+ + + + +-+-+-+-+ +-+ +-+-+ + +
|         |   |           |           | |
+-+-+-+-+-+-+-+-+-+-+-+-+-+-+-+-+-+-+-+-+
