+-+-+-+-+-+-+-+-+-+-+-+-+-+-+-+-+-+-+-+-+-+-+-+-+-+-+-+-+-+-+-+-+-+-+-+-+-+-+-+-+
|   |         |     | |       |         |   |   |       |                       |
+ +-+ +-+ +-+ +-+ + + + +-+ +-+ + +-+-+ +-+ + + +-+-+-+ + +-+-+-+-+-+-+-+-+ +-+ +
|   | | | | |     | |   |   |   | |         | | |     | |   |             |   | |
+ + + + + + +-+-+-+ + +-+ +-+ +-+ +-+-+-+-+-+ + + +-+ + +-+ + +-+-+-+-+-+ + + +-+
| | | | | |   |   | | | |     | |     |     | |   | | |   | |     |   |   | |   |
+ + + + + + + + + + + + +-+-+-+ +-+-+ + +-+ + +-+-+ + + + + +-+-+ +-+ + +-+-+ + +
| |     | | |   |   |   |       |   |   |   |       | | |   |         |     | | |
+ +-+-+-+ + +-+-+ +-+-+ + + +-+-+ + +-+-+ +-+-+-+-+ + +-+-+-+ +-+-+-+-+ +-+ + + +
|   | |   | |   |     |   | |     |     |         | |         |       |   | | | |
+-+ + + +-+ + + +-+-+ +-+-+-+ +-+-+-+-+ + +-+-+ + + +-+-+-+-+-+ +-+-+ +-+-+ + + +
| | | | |   | | |   |         |   | |   |   |   | | |   |     | |   |       | | |
+ + + + +-+-+ + + + +-+-+-+-+-+ + + + +-+-+ + + +-+ + +-+ +-+ + + +-+-+-+-+-+ + +
|   | |   |   | | |         |   | | |     | | | |   |   |   |   |           | | |
+ +-+ +-+ + +-+ + + + +-+-+ + +-+ + +-+-+ + + + + +-+ + +-+ +-+-+ + +-+-+-+ +-+ +
| |     |   |   | | | |   |   | | | |     | | | |   | |   | |   | | | |   |   | |
+ + +-+ +-+-+ +-+ + + + + +-+-+ + + + +-+-+-+ +-+-+ + + +-+ + +-+ + + + + +-+ + +
|   |   |   |   | | | | |     | | | | |       |     | |   | |     | | | |       |
+-+-+ +-+ +-+-+ + + +-+ +-+-+ + + + + + +-+-+-+ +-+-+-+-+ + +-+-+-+ + + +-+-+-+-+
|   |   | |     | |       |   |     | |   |     |         |     |   |   |   |   |
+-+ +-+ + + +-+-+ +-+-+-+-+ +-+ +-+-+ +-+ + +-+-+-+-+ +-+ +-+-+ + +-+ +-+-+ + + +
|   | | | |   |   |         |   |   |     | |     |   | | |     | |   |     | | |
+ + + + + +-+ +-+-+ +-+-+-+-+ +-+ + +-+-+ + + +-+ + +-+ + + +-+-+ +-+ + + +-+ + +
| | | | |   |   |   |       |   | | |     | |   | | |     | |   |   |   | |   | |
+ + + + +-+ +-+ + +-+ +-+-+ + +-+ + + +-+-+ +-+ + + +-+-+ + + + +-+ +-+ +-+ +-+ +
| |   |   | |   |   | |   |   |   |   |   | |   | |     | | | |     | | |     | |
+ +-+ +-+ + + +-+-+ + + + + +-+ +-+-+-+ + + + +-+ +-+-+ + + + +-+-+-+ + + +-+-+ +
|   |   |   |     | | | | | |   |       | |   | |     | | | | |         | | |   |
+ + +-+ +-+ +-+-+ + +-+ + +-+ +-+ +-+-+-+ +-+-+ +-+-+ + + + + +-+-+-+-+-+ + + +-+
| | |   | |     | | |   | |   |     |     |         |   | | |     |       | |   |
+ + + +-+ +-+ +-+ + + +-+ + +-+-+-+-+ +-+-+ +-+ +-+-+-+-+ + + +-+ + +-+-+-+ +-+ +
| | | |   |   |   |   |   | |       | |     |   |       | | |   | |     |   | | |
+-+ + +-+ + +-+ +-+ +-+ +-+ + +-+-+ + + +-+-+ +-+ +-+ +-+ +-+ +-+ +-+-+ + + + + +
|   | |   | | | |   |   |   | |   | | | |   |     | |     |   |       | | |   | |
+ +-+ + +-+ + + +-+-+ +-+ +-+ + + + + + + +-+-+-+-+ +-+-+-+-+ + +-+-+-+ + +-+-+ +
|   | |   |   |     | |   |   | | |   | |                   | |   |     | |     |
+ + + +-+ +-+ +-+-+ + + +-+ +-+-+ +-+ + + +-+ +-+-+-+-+-+-+ + +-+ + +-+-+ + +-+-+
| | |       |   |   |   | |     |     | |   | |     |       |   |   |     |     |
+-+ + +-+-+ +-+ + +-+ +-+ + +-+ + +-+-+ + +-+ +-+-+ + +-+-+-+-+ +-+-+-+ + +-+-+ +
|   | |   | |   |   | |   | | | | |   | | |   |     |   |     | |     | |     | |
+ + +-+ + +-+ +-+-+ + + +-+ + + + + +-+ +-+ +-+ +-+-+-+ +-+ +-+ +-+ + + +-+-+-+ +
| | |   |     |   | | |       | |   |   |   |   |     |   |   |     |   |   |   |
+ +-+ +-+-+-+-+ +-+ + +-+-+-+ + +-+-+ +-+ +-+ +-+ +-+ +-+ +-+ +-+-+ +-+-+ + + + +
|   | |   |   | |   |       | |     |   | |       |     |   |     | |     |   | |
+-+ + + + + + + + +-+-+-+-+ + +-+-+ +-+ + +-+-+-+ + +-+ +-+ + + +-+ + +-+-+-+-+ +
|   | | |   |   |     |   | |   |   | |   |     | | | |   | | |     |   | |     |
+ +-+ + +-+-+-+ +-+-+ +-+ + +-+-+ + + +-+-+ +-+ +-+ + +-+ + +-+-+-+ +-+ + + +-+-+
|     |   |   |     | |   | |     | |         | |   |     |       |   | |       |
+ +-+-+-+ + + +-+-+ + + + + + +-+-+ + +-+-+-+ + + +-+ +-+-+-+-+-+ +-+-+ +-+-+-+ +
| |       | |       | | | | |   |   | |   |   | | | | |         | |   |       | |
+ + +-+ +-+ +-+-+-+-+ + +-+ +-+ + +-+-+ + + +-+ + + + +-+ +-+-+-+ + + +-+-+-+ +-+
| | |   |   |       | |   |     |       |   | |   | |   | |     |   |       |   |
+ +-+ +-+ +-+-+-+ + + + + +-+ +-+-+-+-+-+-+-+ +-+-+ +-+ + + +-+ +-+-+-+-+-+ +-+ +
| |   |   |       | | | |     |       |   |             | | | | |         |   | |
+ + +-+ +-+ +-+-+-+ + +-+-+-+-+ +-+-+ +-+ + +-+-+-+-+-+ + + + + + +-+-+-+ +-+ + +
|   | |   | | |     |   |     |   | |   | | |   |     |   |   |   |     |   | | |
+-+-+ +-+ + + + +-+-+-+ + +-+ +-+ + +-+ + + + +-+ +-+ +-+-+-+ +-+-+-+ +-+ + + + +
|       |   |   |     |   | | |   |   | |     |   | | |     | |   |   |   | | | |
+ + +-+-+-+-+ +-+-+-+ +-+-+ + + +-+-+ + +-+-+-+ +-+ + + +-+ + + + + + + +-+-+ + +
| |                         |         |             |     |     |   | |         |
+-+-+-+-+-+-+-+-+-+-+-+-+-+-+-+-+-+-+-+-+-+-+-+-+-+-+-+-+-+-+-+-+-+-+-+-+-+-+-+-+
