+-+-+-+-+-+-+-+-+-+-+-+-+-+-+-+-+-+-+-+-+
|     |           | |             |     |
+ +-+-+ +-+ +-+-+ + + +-+-+ +-+-+ + +-+ +
|       |   | |   |   |   |   |   | | | |
+ +-+-+-+ +-+ + +-+-+-+ + +-+ + +-+ + + +
| | |   | |   |   |     |     |   | |   |
+ + + + + +-+ +-+ + +-+-+-+-+-+-+ + +-+-+
|   | |   |     |   |     |       |     |
+-+ + +-+-+ +-+ +-+-+ +-+-+ +-+-+-+-+-+ +
|   | |     |   |     |     |           |
+-+-+ + + +-+-+ +-+ +-+ +-+-+-+-+-+ +-+ +
|     | | |   |   | |   |         |   | |
+ +-+-+ +-+ + +-+ + + +-+-+-+ +-+ +-+ +-+
|   | |     | |     | |     |   |   |   |
+ + + + +-+-+ +-+-+ + + +-+ +-+ +-+ +-+ +
| | |   |   |   | | | | | |   |   |     |
+ + +-+-+ + + + + + + + + +-+ +-+ +-+-+ +
| | |   | | | | | | | | |   | |   |   | |
+-+ + + + + +-+ + + + + + + + + +-+-+ + +
|   | |   | |   | | |   | |   | |     | |
+ +-+ +-+-+ + +-+ + +-+-+ +-+-+ + + +-+ +
|       |   |   | |     | | |   | | |   |
+ +-+-+-+ +-+-+ + + +-+-+ + + + +-+ + +-+
| |     | |     |   |     | | |   |   | |
+ + +-+ + + +-+-+ +-+ +-+-+ + +-+ + +-+ +
| |   |   | |       |     | |   | |   | |
+ +-+ +-+-+ +-+-+-+-+-+-+ + + +-+ +-+ + +
| |   |     |         |   |   |   | |   |
+ + +-+ +-+-+ +-+-+-+ + +-+-+-+ +-+ +-+ +
| |   | |   | |     |       |   |     | |
+ +-+ + + + + + +-+ +-+-+-+ + +-+-+ +-+ +
| |   |   |   | | |   |   | |     | |   |
+ + +-+ +-+-+-+ + +-+ + + + + +-+ + + +-+
| |   | |     | |   | | | | | |   | |   |
+ +-+ +-+ +-+ + + + + + + + +-+ +-+ +-+ +
| | |       | | | | | | | | |   |   |   |
+ + +-+-+-+-+ + + + + + + + + +-+ +-+ +-+
| |   | |   |     | | | | | | | |   |   |
+ + + + + + +-+-+-+-+ + +-+ + + + + +-+ +
|   |   | |           |       |   |     |
+-+-+-+-+-+-+-+-+-+-+-+-+-+-+-+-+-+-+-+-+
