+-+-+-+-+-+-+-+-+-+-+-+-+-+-+-+-+-+-+-+-+-+-+-+-+-+-+-+-+-+-+-+-+-+-+-+-+-+-+-+-+
|               |   |   | |           |             |       |     |   |     |   |
+ +-+-+ +-+-+-+ + + + + + + +-+-+-+ +-+ +-+ + +-+-+-+ +-+ + +-+ + + + + + +-+ + +
| |     |     | | |   | | |       |     |   | |       |   |     | | | | |     | |
+ + +-+-+ +-+ + + +-+-+ + +-+-+-+ +-+-+-+ +-+ + +-+-+-+ +-+-+-+-+ + + +-+-+-+-+ +
| |         | |   |   | |       | |   |   | | | |       |       | | | |         |
+ +-+-+-+-+-+ +-+-+-+ + + +-+ +-+ + + + +-+ + + + +-+-+-+ +-+-+ + + + + +-+-+-+ +
|   |     |   |     | | | |   |   | |   | |   | |     |       |   | |   |   |   |
+-+ + +-+ + +-+ +-+ + + + + +-+ +-+ +-+-+ + +-+ +-+-+ +-+-+-+ +-+-+ +-+ + + +-+-+
| | | |     |   |     | | | |   | |     |     | |   |   |   | |     |   | |     |
+ + + +-+-+-+ +-+ +-+-+ + +-+ +-+ +-+-+ +-+-+ + + +-+-+ + + + + + +-+ +-+ +-+-+ +
|   |   |     |     |   |   | |   |   |     | | | |     | |   | |   | |     |   |
+-+-+-+ + +-+ + +-+-+ +-+-+ + + +-+ + +-+-+ +-+ + + +-+-+ +-+-+ +-+ +-+ +-+-+ + +
|     | | |   |   |   |     | |     |     |     | | |   | |   |   |   | |   | | |
+ +-+ + + + +-+-+ + +-+ + + + +-+-+ +-+ +-+-+-+-+ + + + + + + +-+-+-+ + + + + +-+
| |     | | |   | |   | | | |     | | |       |   | | |     |       | | | | |   |
+ +-+-+-+ + +-+ + +-+ +-+ +-+-+-+ + + +-+-+ + + + + +-+-+-+-+-+-+-+ + + + + +-+ +
| |   |   |   |   | |     |     | |       | |   | | |       |         | | |     |
+ + + +-+-+ + + +-+ +-+-+ + + + + +-+-+-+-+ + +-+-+ + +-+-+ +-+-+-+-+ + + +-+-+-+
|   |     | | | |   |     | | | |       |   | |     |     |   |     | | |       |
+ +-+-+-+ +-+ + + + + +-+-+ + +-+-+-+-+ + +-+-+ +-+ +-+ +-+-+ + +-+ + + +-+-+-+ +
|   |   |   | |   | |     | |     |   | |     |   | |   |     | |   | |     | | |
+-+ +-+ +-+ + +-+-+-+-+-+ + +-+ +-+ + + +-+-+ +-+ +-+ +-+ +-+-+ + +-+-+-+-+ + + +
| |   |   | |             |   |     | |     |   |   |   |   |   |             | |
+ +-+ + + + + +-+-+-+-+-+-+-+ +-+-+-+ +-+-+ + + +-+ +-+ +-+ + +-+-+-+-+ +-+-+-+ +
|   | | | | | |       |     |   |         |   |   |   | | |     |     | | |     |
+ +-+ + +-+ +-+ +-+-+ + +-+ +-+ + +-+-+-+-+-+ +-+-+ + + + +-+-+-+ +-+ + + + +-+ +
|   | | |   |     |   | |     | | |       |   |     | |       |   | | |   |   | |
+-+ + + + + + +-+-+ + + + +-+-+ + + +-+-+ + +-+ +-+-+-+-+ +-+-+ +-+ + +-+ +-+ +-+
|   | | | | |   |   | | |       |   |   |   | | |     |   |   | |   |   |   |   |
+ +-+ + + + +-+ + +-+-+ +-+-+-+-+-+-+-+ +-+-+ + + +-+ + +-+ + + + +-+-+ +-+-+-+ +
| |   | | | |   | |     |             |       | |   | | |   | | | |   |   |   | |
+ + +-+ + +-+ +-+ + +-+-+-+ +-+-+-+-+ + +-+-+ + +-+ + + + +-+ + + + + +-+ + + + +
|   |   |     | | |   |   |   |   |   | | |   |   | |   |   |   | | |   |   |   |
+ +-+ +-+-+-+-+ + +-+ + + + + + +-+ +-+ + + + + +-+ +-+-+-+ +-+ + + +-+ +-+-+-+-+
| |       |     |   | | | | | |   | | |   | | |   | |   |   | | | |   |         |
+ + +-+ + +-+ + +-+ + + + +-+ +-+ + + +-+ + +-+-+ + + + + +-+ + + + + +-+-+-+-+ +
| | | | |   | |   | | | |   |   | | |     |     |   | | | |   | | | |       |   |
+ + + + +-+ +-+-+ + + + +-+ +-+ + + +-+ +-+-+ + +-+-+ + + + + + + + +-+-+-+ + +-+
| |   | |       | |   |   |     | |   | |     | |     | | | |   | | |     | | | |
+ +-+-+ +-+-+-+ + +-+-+ + +-+-+-+ +-+ +-+ +-+-+ +-+-+-+ + + +-+-+ +-+ +-+ + + + +
|     |     | |   |     | |     |   | |   |   |   |   | | | |   |     | |   |   |
+-+-+ +-+-+ + +-+ + +-+-+ + +-+ +-+ + + +-+ + +-+ + + + + + + +-+-+-+-+ +-+-+-+ +
|   | |     |   | | |     |   |   |     |   |   |   |   | | |       |         | |
+ + + + +-+-+ + + + + +-+ +-+ +-+ + +-+-+ +-+ + + +-+-+-+ + +-+-+ + + +-+ + +-+ +
| | | |   |   |   | |   | | | |   | |   | |   | | |   |   |       | | |   | |   |
+ + + +-+ + +-+-+-+ +-+ + + + + + +-+ + +-+ +-+ + + + + +-+-+-+-+-+ +-+ +-+ + +-+
| | |     | |     | |   |   | | | |   |   |   | | | |   |         |     |   | | |
+ + +-+-+-+ + +-+ + + +-+-+ + + +-+ +-+-+ +-+ +-+ + +-+-+ +-+ +-+-+-+-+ +-+-+ + +
| | |       |   |   |     | | | |   |   |   |     |     | | |           |     | |
+ +-+ +-+-+-+ +-+-+-+-+-+ +-+ + + +-+ + +-+ + +-+-+-+-+ + + +-+-+-+-+-+-+ +-+-+ +
|   |   |   | |         |     | |   | | |   |       |   | |         |   | |     |
+ + +-+ + + + + +-+-+-+ +-+-+ + +-+ + +-+ +-+-+-+-+-+ +-+ + +-+-+-+ + +-+ + +-+ +
| |   | | | | |     | | |   | |     |   | |   |     | | | | |     |   |   | |   |
+-+-+ + + + + +-+-+ + + + + +-+ +-+-+-+ + + + + +-+ + + + + + +-+ +-+ + +-+-+ + +
|     | | |     |   |     |   |       | |   |   |   | |     |   |     | |     | |
+ +-+-+ +-+-+-+ + +-+-+-+-+-+ +-+-+-+ + +-+-+-+-+ + + +-+-+-+-+-+-+-+-+ + + +-+-+
|     |     |   | |   |   |   |         |         | |     |           | | |     |
+ +-+ +-+-+ +-+-+ + + + + + +-+-+ +-+-+-+ +-+-+-+-+ +-+-+ + +-+-+-+-+ + +-+-+-+ +
|   |     |     |   | | | |     | |   |   | |           |     |       |   |     |
+-+ +-+-+ +-+-+ + +-+ + +-+-+-+ + +-+ + +-+ + +-+-+-+-+-+-+-+-+ +-+-+ +-+ + +-+-+
| | |   |   | | |   | |       | |     |   |       |       | |   |   | |   |     |
+ + + +-+ + + + +-+-+ +-+ +-+ + +-+-+ +-+ +-+-+-+-+ +-+ + + + +-+ + + + +-+-+ + +
|   | |   |   | |     |   |   | |     |   |       |   | |   |     | | | |   | | |
+ +-+ + +-+ +-+ + +-+-+ +-+ +-+ +-+ +-+ +-+ +-+-+ +-+ + +-+ +-+-+-+ +-+ + + +-+ +
|     | |   |   | |   |   |   |   |   |     | |     | |   |   |   | |   | |     |
+-+-+ + +-+-+ +-+ + + + + +-+-+-+ +-+ +-+-+-+ + + +-+ +-+ + +-+ + + + +-+ +-+-+ +
|     |     |     | |   |   |     |           | | |   | | | |   | | |   | |   | |
+ +-+-+-+ + +-+-+-+-+-+-+-+ + +-+-+ +-+-+ +-+-+ +-+ +-+ + + + +-+ + +-+ + + +-+ +
| |     | |     |           |     | |   | |   |     |   | | |   |   |   | |     |
+ + +-+ + + +-+ + +-+-+-+ +-+-+-+ + + + +-+ + +-+-+ + + + +-+-+ +-+-+ +-+ + +-+-+
| |   | | | | | |     |   |     | | | |     |     |   | |     |     | |   | |   |
+ +-+ + +-+ + + +-+-+ +-+ + +-+ + +-+ +-+-+-+-+-+ +-+-+-+-+-+ +-+-+ + + +-+ + + +
|   | | |   | | |   |   | |   |   |   |   |     |       |   |     | |   | |   | |
+-+-+ + + +-+ + + + +-+ + +-+ +-+-+ +-+ + + +-+ +-+-+-+ + + + +-+-+ +-+-+ +-+-+ +
|     |   |       |     |   | |     |   |   |         |   | |     |         |   |
+ +-+-+-+-+ +-+-+-+-+-+ +-+-+ + +-+-+ +-+-+-+-+-+-+-+ +-+-+ +-+ + +-+-+ +-+ + +-+
|     |     |   |     | |   |   |   |         |   |       |   | |     |   | | | |
+ +-+ +-+-+-+ + + +-+ +-+ + +-+-+ + + +-+-+-+ + + +-+-+-+-+-+ +-+ +-+ +-+ +-+ + +
|   |         |     |     |       |         |   |                 |     |       |
+-+-+-+-+-+-+-+-+-+-+-+-+-+-+-+-+-+-+-+-+-+-+-+-+-+-+-+-+-+-+-+-+-+-+-+-+-+-+-+-+
