+-+-+-+-+-+-+-+-+-+-+-+-+-+-+-+-+-+-+-+-+
|       |     |   |       |           | |
+ +-+ +-+ +-+ + + +-+ +-+ + +-+-+ + + + +
| |   |     | | |   |   |   |   | | |   |
+ + +-+ +-+-+ + +-+ +-+ +-+-+ + + + +-+ +
| | |   |     | |   | |   | | | | | |   |
+-+ + +-+ +-+-+ + +-+ +-+ + + + +-+ + +-+
|   | | |   |   |   |   |   | |     |   |
+ + + + +-+ + +-+-+ +-+ +-+ + +-+-+-+-+ +
| | | |   |   |   | |     | |   |       |
+ +-+ + + +-+-+ + + + +-+-+ +-+ + +-+-+-+
| |   | |       | | |     | | | | |     |
+ + +-+ +-+-+ +-+-+ + +-+ + + + + +-+ +-+
| | |       | |     |   |     | |   |   |
+ + +-+-+-+-+ +-+-+-+-+ +-+-+-+ +-+ +-+ +
| |       |   |       |   |     |   |   |
+ +-+-+-+ + + +-+ +-+ +-+-+ +-+-+ +-+ +-+
|       |   | |   | |       | |   |     |
+ +-+-+-+-+-+ + +-+ +-+-+-+-+ + +-+-+-+ +
| |   |       | | |       |     |       |
+ + + + +-+-+-+ + + +-+ + + +-+-+ +-+-+ +
| | |   |   |   | | | | | | |     |   | |
+ + +-+-+ + + +-+ + + + +-+ + +-+-+ + + +
| |       |   |   | | |     | |     |   |
+ +-+-+-+-+-+-+-+ + + +-+-+-+ + +-+-+-+-+
|                 |   |   |   |         |
+ +-+-+-+-+ +-+-+-+-+ + + + +-+-+-+-+-+ +
| |   |   |         |   | |       |   | |
+ + + + + +-+-+-+ + +-+-+ + +-+-+ + +-+ +
| | | | |   |   | |     | | |   | | |   |
+ + + + +-+ + + + +-+-+ + + + + + + + +-+
|   | |   | | | | |     | | | |   | |   |
+-+-+ +-+ +-+ + + +-+-+ + +-+ +-+-+ +-+ +
|   | |   |   |   |   | |   | |       | |
+ +-+ + + + +-+ +-+ + +-+-+ + + +-+-+ + +
|   |   | | |   |   |       | | |   | | |
+ + +-+-+ + +-+-+ +-+-+-+-+-+ + + + + + +
| |   |   |   |   |   |     | |   | | | |
+ +-+ + +-+-+ + +-+ + +-+ + + + +-+ +-+ +
|   |       |       |     |   |   |     |
+-+-+-+-+-+-+-+-+-+-+-+-+-+-+-+-+-+-+-+-+
