+-+-+-+-+-+-+-+-+-+-+-+-+-+-+-+-+-+-+-+-+
|   |   |     |                         |
+ + + + + + + + +-+ +-+-+-+-+-+ +-+-+-+ +
| | | |   | | | | |   |   |     |     | |
+ + + +-+-+ +-+ + +-+ + + +-+-+-+ +-+ + +
| |       |   | |   | | |   |     |   | |
+ +-+-+-+-+-+ + +-+ + + +-+ + +-+-+ +-+ +
|   | |       |   | |   |   |     | | | |
+-+ + + +-+-+ +-+ + +-+-+ +-+-+-+ + + + +
|   | | |   | | |   |   |         | |   |
+ +-+ + + + + + +-+ + +-+-+-+-+-+-+ + +-+
| |   |   | | |   |   |   |     |   | | |
+ +-+ +-+-+ + +-+ +-+ + + + +-+ + +-+ + +
|   | |   | |     |   | |   |     | | | |
+-+ + + + + + +-+-+ +-+ +-+-+-+-+-+ + + +
|   | | | | | |   |   |         |     | |
+ +-+ + + + + + + +-+ +-+-+-+-+ +-+ +-+ +
| |   | |   | | |   | | |     |   | |   |
+ + + + +-+-+ + +-+ + + + +-+ + + + + +-+
|   | | |     | | |     |   | | | | |   |
+-+ +-+ + +-+-+ + +-+-+-+-+ + +-+ + + + +
| | |   |     | |   |   |   |     | | | |
+ + + +-+-+-+ + + +-+ + + +-+-+-+-+ +-+ +
|   |     | | | | |   | | |       | |   |
+ +-+-+-+ + + + + + +-+ + + +-+-+ + + + +
|   | |   |   |   | | |   |   |   |   | |
+-+ + + +-+-+-+ +-+ + +-+ + +-+ +-+-+-+ +
|     | |   |   |   | |   | |   |     | |
+-+-+-+ + + + +-+ +-+ + +-+ + +-+ +-+ + +
|     | | | |   |   |   |   |   | |   | |
+ +-+ + + + +-+ +-+ +-+ + +-+-+ + + +-+ +
|   |   | |   | | |   | | |   | | |   | |
+ + +-+ + +-+ + + +-+ + + +-+ + + +-+ +-+
| | |   |   | | |   | | |   | | |   |   |
+ + + +-+-+ + + + + + + +-+ + + +-+ +-+ +
| | | |     |   | | | | |   | |       | |
+-+ + + +-+-+-+-+-+ + +-+ +-+ +-+-+-+-+ +
|   | | |   |     | |   | |   | |       |
+ +-+-+ + + + +-+ + +-+ + + + + + +-+-+ +
|         |   |       |     |   |     | |
+-+-+-+-+-+-+-+-+-+-+-+-+-+-+-+-+-+-+-+-+
