+-+-+-+-+-+-+-+-+-+-+-+-+-+-+-+-+-+-+-+-+-+-+-+-+-+-+-+-+-+-+-+-+-+-+-+-+-+-+-+-+
|   |       |     |         |     |             |             |     |   |   |   |
+ +-+ +-+-+ + + +-+ +-+-+-+ + +-+ + +-+ +-+-+-+ +-+ +-+-+-+-+-+ + +-+ + + + + + +
|   | |   |   |   |       |     |     |   |   | |   |     |     | |   |   |   | |
+-+ + + +-+-+-+-+ +-+-+-+ +-+-+-+ +-+-+-+ + + + + + + +-+ + +-+-+ + +-+-+-+-+-+ +
|   | | |       |   |     |     | |       | |     | |   |   |   | |   |   | |   |
+ + + + + +-+ + + +-+ +-+-+ +-+ +-+ +-+-+-+ +-+-+-+-+-+ +-+-+ + + +-+ + + + + + +
| | | |   |   | |   |     | |       |     |     |     | |     | |   |   |   | | |
+ + + +-+-+ +-+-+-+ +-+ +-+ + +-+-+-+-+-+ +-+-+ + +-+ + + +-+-+ + +-+-+-+-+ + +-+
| | |   |   |     |     |   |   |       |     | |   |   |   |   |           |   |
+ +-+-+ + +-+ + + +-+-+-+ +-+-+-+ +-+-+ + +-+ + +-+ +-+-+ +-+ + +-+-+-+-+-+-+-+ +
|       |   | | | |     |           |   |   |   |   |     |   | |               |
+ +-+-+-+ + + + + + + +-+-+-+-+-+-+-+ + +-+-+-+-+ +-+-+-+-+ +-+ + +-+-+-+-+-+-+ +
| |     | |   | | | |         | |     | |         |   |     | | |   |   |       |
+ + +-+ +-+-+-+ + + +-+ +-+-+ + + +-+ +-+ +-+-+ +-+ + + +-+-+ + +-+ + +-+ +-+-+-+
|   | |         | | | | |   | | |   | |   |   |     | |   |   | | | |   |   |   |
+-+-+ +-+-+-+-+-+ + + + + +-+ + +-+ +-+ +-+ + + +-+-+ +-+ +-+ + + + +-+ +-+ +-+ +
|             |   |   | |   |   | |   |   | | | |   |   |   |   | |   |   |   | |
+ +-+-+-+-+-+ + +-+-+ + +-+ +-+ + +-+ + +-+ + +-+ + +-+ +-+ + +-+ +-+ + + +-+ + +
|           | | | |   | |     |   |   | |   |     |   |     |   |   | | |       |
+ +-+-+-+-+ +-+ + + +-+ + + +-+-+ + +-+ + +-+-+-+-+-+ +-+-+-+-+ + +-+ +-+-+-+-+-+
| |       | |   | |   | | | |   | |     | |         | | |       |   |           |
+ +-+ +-+ + + +-+ +-+ + + +-+ + + +-+-+-+ +-+-+-+-+ + + + +-+-+-+-+ +-+-+-+-+-+ +
| |   |   |   |       | |     | |     | |         | | | | |       |     |     | |
+ + +-+ +-+-+-+ +-+-+-+ + +-+-+ +-+-+ + +-+-+-+-+ + + + + + +-+-+ + +-+ + + +-+ +
|   | | |   |   |       |   |   |   |   |   |     |   |     |   |   |     | |   |
+-+-+ + + + +-+-+ +-+-+-+-+-+ + + + +-+ +-+ + +-+-+ +-+-+-+-+ + +-+ +-+-+-+ + +-+
|   | |   | |     |           |   |   |     |     |           | |   |   |   | | |
+ + + +-+-+ + +-+-+ +-+ +-+-+-+-+-+-+ +-+-+ +-+-+ +-+ +-+-+-+-+ + +-+ + +-+-+ + +
| |   | |   | |       |   |       |       |     | |   |   |   | |   | | |     | |
+ +-+ + + +-+ +-+-+-+-+ + + +-+-+ + +-+-+-+-+-+ + + +-+ +-+ + + +-+-+ + + +-+-+ +
| | |   |   | |   |   | | |     | | |   |   |   | | |   |   | |   |   |   |     |
+ + +-+ +-+ + + + + + +-+ + +-+-+ + + + + + + +-+ +-+ +-+ +-+ +-+ + +-+-+-+-+-+ +
| |       | | | | | |   |   |     | | |   |   | | |   |   |     |   |   |       |
+ +-+-+-+ + + + + + +-+ +-+-+ +-+-+-+ +-+-+-+-+ + + +-+ +-+-+-+-+-+-+ + + + +-+ +
|       | | |   |   | |     |         |       | |   | |               | | | |   |
+ +-+-+ +-+ + +-+-+-+ +-+-+ +-+ +-+-+-+ +-+-+ + +-+-+ + +-+-+-+-+-+-+ + + + + +-+
| |   | |   |     |       |   | |       |   | |         | |     |   | | | | |   |
+ +-+ + + +-+-+-+ +-+ +-+-+-+ + +-+-+ +-+ +-+ + +-+-+-+-+ + +-+ + + + + +-+ +-+-+
|     | | |     |   | |       |   |   | |     |     |     | | |   |   |   |     |
+-+-+ + + + + +-+-+ + + +-+-+-+-+ + +-+ + +-+-+-+-+ + + +-+ + +-+-+-+-+-+ +-+-+ +
| |   |   | |         |     |   |   |   | |       |   | |   |       |     |   | |
+ + +-+-+-+-+-+-+ +-+-+ +-+ + + +-+-+ + + + +-+-+ +-+-+ + +-+ + +-+-+ +-+-+ + + +
|   |           | |   |   |   | |     | | | | |   |   | | |   | |   | | |   |   |
+ +-+ +-+-+-+-+ + + + +-+-+ +-+ + +-+-+-+ + + + +-+ + +-+ + +-+ + + + + + + +-+ +
| |   |       | | | |     |   | |         | | |     | |   | |   | |   |   | |   |
+ + +-+ +-+-+ + +-+ +-+-+ +-+-+ + +-+-+-+-+ + +-+-+-+ + +-+ +-+-+ +-+-+ +-+ + +-+
| |       |   |   | |   |       | |   |     |   |   |   |     |   |     |   | | |
+ +-+-+-+ + +-+-+ + + +-+-+-+-+-+ + + + + +-+ + + + +-+-+-+-+ + +-+-+ +-+ +-+ + +
| |   |   |     |   |         |   | |   |   | |   |   |       |     | | |   | | |
+ + + +-+-+-+-+ +-+-+ +-+ +-+ + +-+ +-+-+-+ + + +-+-+-+ + +-+-+-+-+ + + +-+ + + +
|   |   |       |   | | |   | |   |   |     | | |       |   |       |     | |   |
+-+-+-+ + +-+-+-+ + + + +-+ + +-+ +-+-+ +-+-+ + + +-+-+-+-+ + +-+-+-+ +-+-+ +-+ +
|     | |     |   |   |   | |   |     | |     | | |   |   | |       | |     | | |
+-+ + + +-+-+ +-+ +-+-+ + + +-+-+-+-+ + +-+ + + + + + +-+ + +-+-+-+ + + +-+-+ + +
|   | |     |   | |   | | |     |   | |   | | | | | |     | |     | | |     | | |
+ +-+ +-+-+ +-+ + + + + + +-+-+ + + + + + +-+ +-+ + +-+-+ + + +-+ + + +-+-+ + + +
| |       |     |   | | |     |   |   | |   |     | |     |   |   | |   |   |   |
+ +-+-+-+ +-+-+-+-+-+ + + +-+ +-+-+-+-+ +-+ +-+ +-+ + +-+-+-+-+ + + +-+-+ +-+ +-+
|   |   |   |   |     | | | |         |   |   | |   |   |     | | | |     |   | |
+-+ + + +-+-+ + + +-+-+ + + +-+-+-+-+ +-+ +-+ + +-+ +-+ + +-+-+ + + + +-+-+ +-+ +
|   | |       | | |     | |   |       | | |   |     | |   |   | | | | | |   |   |
+ +-+ +-+-+-+-+ + +-+-+-+ + + + +-+-+-+ + + +-+-+-+-+ +-+ + + + + + + + + +-+ +-+
| |   | |     | | |       | |   |     |   |   |           | | | | |   | |   |   |
+ + +-+ + +-+ + + + +-+-+-+ +-+-+ +-+ +-+-+-+ +-+ +-+-+-+-+ + + + +-+-+ +-+ +-+ +
|   |   |   |   | | |     |   |     |   |   |   |     |   | |   | |       | |   |
+ +-+-+ +-+ + +-+ + + +-+ +-+ + +-+ +-+ + + +-+ + +-+-+ + + +-+-+ +-+ +-+-+ + +-+
| |     |   | |   | | | | |   |   |   |   | |   | |     | | |   |   |   |   |   |
+ +-+ +-+ +-+-+ +-+ + + + + +-+-+-+-+ +-+-+ + +-+ + +-+-+ + + + +-+ +-+ + +-+-+ +
|   |   |     | |   | | | | |   |   |   | |   |   | |   | | | | | |   | | |     |
+-+ +-+ +-+-+ + + +-+ + + + + + + + +-+ + +-+-+-+-+ + +-+ + + + + +-+ + + +-+ + +
| |       | |   | |   | | |   | | |   | | |         |       | | |       |   | | |
+ +-+-+-+ + +-+-+ + +-+ + +-+-+ + +-+ + + + +-+ +-+-+ +-+-+-+ + +-+-+-+ +-+ + +-+
|       | |       |   | |     |   |   | |   | | |   | |   |   |     |     | |   |
+ + +-+-+ + +-+-+ +-+ + + +-+-+-+-+ +-+ + +-+ + + + + + + + +-+-+-+ +-+-+-+ +-+ +
| |     | | |   | |     |       |   |   |     | | | | | |   |     | |     | |   |
+ +-+-+ + +-+ + + +-+-+-+ +-+-+ + +-+-+ +-+-+ + + +-+ + +-+-+-+-+ + + +-+ + + + +
| |     |     | |       |   |   | |   |   | | | |     |   |     | | | | | | | | |
+ + +-+-+-+-+-+ +-+-+-+ +-+ + +-+ + + +-+ + + + +-+-+-+-+ + +-+ + + + + + + + + +
| |                     |   |       |     |   |             |     |     |     | |
+-+-+-+-+-+-+-+-+-+-+-+-+-+-+-+-+-+-+-+-+-+-+-+-+-+-+-+-+-+-+-+-+-+-+-+-+-+-+-+-+
