+-+-+-+-+-+-+-+-+-+-+-+-+-+-+-+-+-+-+-+-+
|   |             |     |   |     |     |
+ + + +-+-+-+-+ + + +-+-+ + + + + +-+ + +
| |   |     |   | | |     | | | |     | |
+ +-+-+-+ + + +-+ + + +-+-+ + + +-+-+-+ +
| |     | | | |     |   | | | | |   |   |
+ + +-+ + +-+ +-+-+-+-+ + + +-+ + + + +-+
| | | |   |   | |     | | |     | |   | |
+ + + +-+ + +-+ + +-+ + + +-+-+-+ +-+-+ +
|   |     |   |   | | | |     |   |     |
+-+-+-+-+ +-+ +-+-+ + + +-+ + + +-+ +-+ +
|   |   |   |       | |   | | |     |   |
+ + + + +-+-+ +-+-+ + +-+ + +-+-+-+-+ +-+
| |   | |     |     |     |   |     | | |
+ +-+-+ + +-+-+-+-+ +-+-+-+ + + +-+ + + +
|   |   |         | |   |   |   | |   | |
+ + + +-+-+-+ +-+ + + + + +-+-+-+ +-+-+ +
| | |       |   | |   | | |   |         |
+-+ + +-+-+ +-+ + +-+-+ + + + +-+-+-+-+ +
|   | |   |   | |     | |   |           |
+ +-+-+ + +-+ + +-+-+ +-+-+-+-+-+-+-+-+ +
| |   | | | | | |   |       |   |   |   |
+ + + + + + + + + + +-+ +-+ + + +-+ + +-+
|   |   | | | | | |     | |   |     |   |
+ +-+-+-+ + + + + +-+-+-+ +-+-+-+-+ +-+ +
| |   |   | | | | | |   |       |   |   |
+-+ + + +-+ + +-+ + + + + +-+-+ + +-+ +-+
|   |   |   |     |   | | |   | | |   | |
+ +-+-+-+ + +-+-+-+-+-+ + +-+ + + + +-+ +
|   |     |             | |   |   |     |
+ + + +-+-+-+ +-+-+-+-+-+ + + +-+-+-+-+ +
| | |       |       |   |   | |       | |
+ + +-+-+-+ +-+-+-+ + + +-+ +-+ +-+-+ + +
| | |     |   |   |   |   | |   |   |   |
+ + + +-+ +-+ +-+ +-+-+ +-+ + +-+-+ +-+-+
| |   | | |           |   | |     |     |
+ +-+-+ + +-+-+-+-+-+-+ + + +-+-+ +-+-+ +
| |     | |   |   |   | |       |     | |
+ +-+ + + + + + + + + +-+-+-+-+-+-+-+ + +
|     | |   |   |   |                   |
+-+-+-+-+-+-+-+-+-+-+-+-+-+-+-+-+-+-+-+-+
