+-+-+-+-+-+-+-+-+-+-+-+-+-+-+-+-+-+-+-+-+-+-+-+-+-+-+-+-+-+-+-+-+-+-+-+
| |       |   |           |     |     |       |           |           |
+ + +-+ + + + + +-+-+-+ +-+ + +-+ + +-+ +-+ +-+ +-+-+-+-+ + +-+-+-+-+ +
| | | | | | | | |     |   | |     |   |   |   |   |   | | | |       | |
+ + + + + + + + + +-+ +-+ + +-+-+-+-+ +-+ +-+ +-+ + + + + + + +-+ +-+ +
| |   | | | |   | |     | |       | |     | |     | |   |   | | | |   |
+ +-+ + +-+ +-+-+ + +-+-+ +-+-+-+ + +-+-+-+ +-+-+-+ +-+-+-+-+ + + + + +
| |   |   | |     | |     |     | | |         |   |           |   | | |
+ + +-+-+ + +-+-+ +-+ +-+ +-+-+ + + + +-+ +-+ + + +-+-+-+-+ +-+-+ + + +
|   |     | |   | |   | |   |   | |     |   |   | |       |     | | | |
+ +-+ +-+-+ + + + + +-+ +-+ + + + + +-+-+-+ +-+-+ + +-+-+ +-+-+ +-+ + +
|   |         |   | |     | | | | | |       |   |   |           |   | |
+-+ +-+-+-+-+-+-+-+ +-+ + + + +-+ + + +-+-+-+ + + +-+-+-+-+-+-+-+ +-+ +
| |   |   |   |   |   | | |   |   | |   |     |   |               | | |
+ +-+ + +-+ + + + +-+ +-+ +-+ + +-+-+-+ +-+-+-+ +-+ +-+-+-+-+-+-+-+ + +
|   | | |   |   |   |   |     | |   |   |     | |   |       |         |
+ +-+ + + +-+-+-+-+ + + + +-+-+ + + + +-+ +-+ +-+ + + +-+-+ +-+-+-+ +-+
|     | |   | |     | | | |     | | |     |   |   | | |   |   |   | | |
+ +-+-+ +-+ + + +-+-+ + + + +-+-+ + +-+-+-+ + + +-+ + + +-+-+ + + + + +
|         | | | | |   | | |   |   |       | | | |   | | |     | | | | |
+-+-+-+ +-+ + + + + +-+ + +-+ + +-+-+-+-+ + + + + +-+ + + +-+-+ + + + +
|     | |   |   |     | | |   |     |   |   | | | |   | |   |   | |   |
+ +-+ + + +-+ +-+ +-+-+ + + +-+ +-+ + + + +-+-+ + + +-+ +-+ + +-+ +-+ +
| | | | |   |   | |     | | |   |   | | | |     | |     | | |   |   | |
+ + + + +-+ +-+ +-+ +-+-+ + +-+ + +-+ + + + +-+-+ +-+-+ + + + +-+-+ + +
| | | | |   |   |   |   | |   | |   | | | | |         |   |   |   | | |
+ + + +-+ +-+-+ + +-+ + +-+-+ + +-+ + +-+ + +-+-+-+-+-+-+ +-+-+ + + + +
| |     |     |   |   |     | | |   | |   | |   |       |   |   | | | |
+ +-+-+ +-+-+ +-+ + +-+-+ + + +-+ +-+ + +-+ + + + +-+-+ +-+ + +-+ + +-+
|     | |     | | | |   | | |   |   |   |   | |   |   |     | | | |   |
+ +-+ + + +-+-+ + + + + + + +-+ +-+ + +-+ +-+ +-+-+ +-+-+-+-+ + + +-+ +
|   | | |     | | | | | | | | |     | |   |   |     |         | |   | |
+-+ + + +-+-+ + + + +-+ + + + +-+-+-+ + +-+ +-+ +-+-+ +-+-+-+-+ +-+ + +
| | | |       |   |     | |   |     | |     |   |   |   |     |     | |
+ + + +-+-+-+ +-+-+-+-+ + +-+-+ +-+ + +-+-+-+ +-+-+ +-+ + + + + +-+-+ +
|   |   |     |     |   |     | | |   |   |       |   | | | | | |     |
+ +-+-+ + +-+-+ + +-+ +-+-+-+ + + +-+-+ + +-+-+ + +-+ + + + + + + + + +
|   | | | |   | | |   |       |     |   |     | |   | | | | | | | | | |
+-+ + + + + +-+ + + +-+ +-+-+ +-+-+ +-+ +-+-+ + +-+-+ + + + + + +-+ + +
| | | | |   |   | |   |     |     |     |   | |     | | | | | |   | | |
+ + + + +-+-+ +-+ +-+ +-+-+ + +-+-+-+-+-+ +-+ +-+ + + + +-+ + +-+ + +-+
|     |   |   |     |     | | |         |   |   | | | | |   | |   |   |
+-+-+-+-+ + +-+ +-+-+-+-+ + +-+ +-+-+ + +-+ +-+ +-+ + + + +-+ + +-+-+ +
|   |   | | |   |       | | |   |   | |       |     |   |   | | |     |
+ + + + + + + +-+ +-+ +-+ + + +-+ +-+ +-+-+-+ +-+ +-+-+-+ + +-+ + +-+ +
| |   |   | |     | |     |   |   |   |   |     | |       |     | | | |
+ +-+-+-+-+ +-+-+-+ +-+-+-+-+-+ + + +-+ +-+ +-+-+ + +-+-+-+-+-+-+ + + +
|   |       |     |     |       | |   |     |     | |             | | |
+-+ + +-+-+-+ +-+ + +-+ + +-+-+-+ +-+ +-+-+ + +-+-+ + +-+-+-+-+-+-+ + +
|   | |   |   |   | |   | |   |     |     | | |     |   |   |     |   |
+ +-+ + +-+ + + +-+-+ +-+ + + + +-+-+-+-+ +-+ + +-+-+ + + + + + +-+ +-+
|   | |     | |     |     | | |         |     | |     | | |   | |   | |
+-+ + +-+ +-+ +-+-+ +-+-+-+ + +-+-+ + +-+-+-+-+ +-+-+-+ +-+ +-+ + +-+ +
|   |   | |   |         |   |     | |     |   | |     |   | | |   |   |
+ + +-+ +-+ +-+-+-+-+-+ + +-+-+-+ +-+-+ + +-+ + + +-+ + + + + +-+-+ + +
| |   |   | |     |     | |     |   |   |   | |   | | | | |         | |
+ +-+-+-+ + + +-+ + +-+-+ +-+ +-+-+ + +-+-+ + +-+-+ + + + +-+-+-+-+-+-+
|     |   |   |   |       |   |   | |   | |         | | |             |
+ +-+ + +-+ +-+ +-+-+-+-+-+ +-+ + + + + + +-+-+-+-+ + + +-+-+-+-+-+-+ +
| | | | |     | |   |         | |   | | |   |       | |   |   |     | |
+ + + + + +-+-+ + + + +-+-+-+ + +-+-+ + + +-+ +-+-+-+ +-+ + + + +-+ + +
|   | | | | |   | | | | |     |   |   | |   |       |   | | |     | | |
+-+ + + + + + +-+ + + + + +-+ +-+ +-+-+ + + +-+-+-+ +-+ + +-+-+-+ + + +
| | |   | | | | | |   | | |   |   |   | | |   |     |   |     |   | | |
+ + +-+-+ + + + + +-+-+ + +-+-+ +-+ + + +-+-+ + +-+-+ +-+-+-+ +-+-+ + +
|   |       | |   |     |       |   | |   |   |     | |     |       | |
+ +-+-+-+-+-+ + +-+ +-+ +-+-+-+-+-+ + +-+ + +-+-+-+ + + + +-+-+ +-+-+ +
|         |   | |   | |     |   |   |     |       | | | |       |   | |
+-+-+-+-+ + +-+ +-+ + +-+-+ + + + +-+-+-+-+ +-+ +-+ + +-+-+-+-+-+ + + +
|           |       |         |   |           |     |             |   |
+-+-+-+-+-+-+-+-+-+-+-+-+-+-+-+-+-+-+-+-+-+-+-+-+-+-+-+-+-+-+-+-+-+-+-+
