+-+-+-+-+-+-+-+-+-+-+-+-+-+-+-+-+-+-+-+-+
|               |                       |
+ +-+-+-+-+-+-+ + +-+-+-+-+ +-+-+ +-+-+ +
|       |   |   |     |     |   | |   | |
+-+-+-+ +-+ + +-+-+-+ +-+-+-+ + +-+ + + +
|   | |   |           |   |   |     | | |
+ + + +-+ + +-+-+-+-+-+ + + +-+-+-+-+ + +
| |   |   | |           | | | |       | |
+ +-+ + +-+-+ +-+-+-+-+-+ + + + +-+-+-+ +
| |   |     |       |     | | |   |     |
+ +-+ +-+-+ +-+-+-+ + +-+ + + +-+ +-+ +-+
|   | |   |       | |   | |     |   |   |
+ + + + + +-+ +-+-+ +-+ +-+-+ +-+-+ +-+ +
| | |   | | |       | |   |   |   |   | |
+-+ +-+-+ + +-+-+-+-+ +-+ + +-+ + +-+ + +
|   |   | |   |       | | | | | |     | |
+ +-+ +-+ + + + +-+-+ + + + + + +-+-+-+ +
| |   |   | | |     | | |     | |     | |
+ +-+ + +-+ + +-+-+ + + +-+-+-+ + + + + +
|   | | |   |       |     |     | | | | |
+-+ + + +-+ +-+-+-+-+ +-+-+ +-+-+ + + + +
|   |       |       | |     | |   | | | |
+ +-+-+-+-+ +-+-+-+ + +-+-+-+ + +-+ +-+ +
|     |     |     |   |       |   |     |
+ +-+ +-+-+-+ +-+ +-+-+ + +-+ +-+ +-+-+-+
|   | |       | |     | | |     | |     |
+-+-+ + +-+-+-+ +-+-+ + + +-+-+ + +-+ +-+
|     | | |     |     | |     | |   |   |
+ +-+ + + + +-+ + +-+-+ +-+-+ +-+-+ + + +
|   | | |   |   |       |   |     | | | |
+-+ + + +-+-+ + +-+-+-+-+ +-+-+-+ + +-+ +
|   | |       | |       |   |     | |   |
+ +-+-+-+-+-+-+ +-+-+ + +-+ + +-+ + + + +
| |       |     |     |   | |   | |   | |
+ + +-+-+ + +-+-+ +-+-+-+ + +-+ +-+-+-+ +
| | |   | | |   |     | |     |     |   |
+ + +-+ + + + + +-+ + + +-+-+ +-+ +-+ +-+
| | |   |   | |   | | |     |   |   |   |
+ + + + +-+-+ +-+ +-+ + +-+ +-+ +-+ +-+ +
|     |       |       |   |       |     |
+-+-+-+-+-+-+-+-+-+-+-+-+-+-+-+-+-+-+-+-+
